00000000000000000000
00110000011101012020
00101010100101011000
00131012101101111010
00101010151011003510
11101010001010010110
00101410121011110010
00111010010110001010
01101111111001511210
01000010001131001010
01110110202101102310
00011101010101011010
01110101010111301411
00550101110040101010
01111001011111101000
01000111000001031100
01111001111111110100
00102000050100000100
00141111111111211110
00000000000000000000