00000000000000000000
00110000011101010000
00111111010011101100
00101011101101110010
00101010101011001110
11111011001111010010
00101010111001101100
00101010010110001010
01101111111001011110
01000010001101001010
01111101001011011110
00000101010101011010
01110101010111101111
01000101110000101010
01111101011111101000
01000000000001011100
01111111111111110100
00101000000100000100
00101111111111110110
00000000000000000000
