00000000000000000000
00110000011101010000
00101210100111011000
00131011101101111010
00101010151011001110
11101010001010010010
00101410111011110110
00111010010110001010
01101111111001511110
01000010001131001010
01110110100101101110
00011101010101011010
01110101010111101111
01050101110040101010
01111001011111101000
01000111000001011100
01111001111111110100
00101000050100000100
00141111111111110110
00000000000000000000
