00000000000000000000
00110000011101010000
00101210100111011000
00101011101101111010
00101010101011201110
11111011001010010010
00101010111011110110
00111010010112001010
01101111111001011110
01002010001101001010
01110110100101101110
00011101012101011010
01110101010111101111
01000101112000101010
01111001011111101000
01000111002001011100
01111001111111110100
00101000000100000100
00101111111111110110
00000000000000000000
