00000000000000000000
01314151141151412100
02000001013020015400
03102345301202120030
04101010101011002230
13211213201325014010
02101010111001105100
03201010010110501010
02403115111001011310
02044012423121001010
01322101021211052510
05050101210321011010
03410101212415505341
04200101310004102340
02213101515144103250
03002004020403351100
05113112112111110100
00101004020400000100
00101155241315101100
00000000000000000000
